一	二
人	入	八	儿	
大	
小
个
了
从	以
几	九	力	刀
刀	万	方
房	旁
为	办
介	分	份	
生	王	主	住	任
十
土	士
干	于	千	
午	牛	件	许
上	止	正	证
三	兰
山	
出
口	门	们
未	末	禾
怎
昨	作	做
已	己	巳
包	抱	饱
巴	色
把	吧
唱	帽
吃
久	之	
心	必	
七	匕	比	化	它	
日	目	耳	
月	朋	明	用	
日	白	百
目	自
且	直	宜
其	真	直	具
皿	血	而	且
身
亚	业
开	并
不	下	
还	送	这	让
李	季	突
木	本
休	体	什
床	庆	厌
术	犬	太
来	米
斗
头	买	实	卖
你 	您	尔
火	灭	灾
伙	认
灯	忙
队
我	找	试	钱	饿	
的	时	
看	着	春	羞	差
复	夏	
更	史
便	使
是	走	定	足	起	越
题	提	
舟	船	般	搬	航	股
铅	船	盘
老	考	者
也	世	他	地	她
比	北
右	石	后
反	友	发	饭	
及	乃	奶
四	西	酒
得	待	特	持	
等	第	弟	梯
和	知	如
光	无	先	尤
五	互
毛	手	丰
乐	东
车	年
书
平	乎	伞	苹
话	活	刮	舌	告	
故	估
胡	湖
刮	乱	
甜	舒
苦	草	早
衣	农	表	
才	牙	穿
只	识
否	杏	
杏	李	香
保	误
果	束	桌
课	稞
谁	准	难	推
去	丢	法	去
到	倒	
或	成	咸	感
城	诚
回	
可	句
司	同	词
问	间	闻	简
同	向	尚	
何	河	
尚	党
当	档	挡	扫
首	道
音	晋	普
章	竟	童
消	肯
有
育	至	
能	熊
最
阿	啊	响
奇	骑	椅
付	讨	过	村	衬	
对	戏	
树	谢	
附
街	班
材	村
坏	环	怀	杯	林
工	红	江
在	左
天	夫	末	失	矢
半	羊	关
元	完 	玩	远	园	
因	困	医	国
风	网	区	凶
刚	则
盐 	监	蓝	篮
清	情	请	猜
晴	睛
垂	睡	重	量	董	懂		
意	息	思
往	住	注
望	室
内	肉
又	文	双	叉	汉
及	板	极	级
取	敢	期
改	教	叔	数
数	楼
很	根	银	眼	跟	
路	跑	跳	踢
各	名	客	备		
变	恋
茶	菜
药	约
借	错
短	矮
查	香
雨	雪
然	热
雪	需	零
丈	戈	
次	欢	饮
角	通	解
确	碗
喝	渴
啤	喂	脾
亮	高	
喜	
冒
巾	市	节	布	币	带	
希	帮
水	永	冰	泳
冷	零	邻
子	字	学
存	仔
好
习	勺	寸	羽	匀
勺	句
母	每	海
由	甲	申	田	单	电	中
里	理	埋
油	邮
男	界
再
面
画
留
黄	
典
全	金
六
尖
空	容	穷	究	穿	突
今	令	
会	合	答	给
绍	织	
练
台	治	抬	始
马	鸟	岛	鸡
吗	码	妈
与	写
爱	受
夕	多	岁	死
外	处
哥	歌
顺	须
帅	师
朵	杂
想	箱
相	租	粗	祖	姐	
助
功	切	动
黑
京	凉	谅	就	
竞	竟	镜	境
亭	停	亮
常	堂	党	掌
影	
号	亏
另	别
兄	克	兑	说
祝	况
迎
虫	虽	蛋
鱼	色	免	兔	晚	换
央	英	束	决	速
筷
觉	尚	赏
历	厉
穷	究
报
皮	被	破	波	婆 
技	按	接	枝	被
怪	择
女	安
妹	
姨
努
辛	幸	南
洋	样	详	
胖	脏
糕
争	净	静
鲜
商	墙	增	窗	
志	忘
离
应	兴
公
么	云	层	运	动
动	边
少	吵	秒	炒	抄
步
长	片	卡	张
记	纪
语
信
富	福
瓜	抓	爬
起	赶	超	趣
遍
慢	漫
科	料
叫	加	咖
收	放	游	旅
见	贝
页	负	员	贵	货
现	视
费	赛	责	绩	惯
烦	须	顺	颜	顾	预
财	败	购	赚
货	资
段	锻
场	杨	物	吻	
易	踢	
急
家	豪	逐
像	象	橡	豫
原	愿	
照
厚
初 	机
利	
刻	咳	孩	该
读	续
义	父	交	
爸	爷
义	议
较	校	效
结
经	轻	
盒	拿	事
妻	
种	钟
服	脑
脸	险	验	检	捡
脚	腿
计	汁
打	针	钉	扎
花	化	华	毕
此	些
进	讲
立	位	拉	垃
陪	部	都	倍
陈	院	阵	
阳	阴
那	哪
快	块	决
总	聪
招	超
店	居
周	调
厂	广		
产	严
尸	户	护
声	
飞	疒
气	汽
病	疼	瘦
参
务
冬	疼	终	图
求	球	秋	
炼	
绿
康	
铁
票	漂	条
但	怕	担	旧
桥	娇
建	键	健
两	俩	辆	满
即	既
狠	狼
竟	镜	境
星	胜	性	姓
竞	竟
据	剧
傅	博
巨	臣 	距	拒
仍	扔
遇	偶
辣	判
裙	群
释	译	
占	点	
古	吉	害
店	站	战
卓	桌	掉
前	偷	输 	俞	
系	累	杀	示
余 	亲	除	涂	途
礼	社	衫
没	设	投
嗳	暖
要	耍
非	兆	北	啡
命
哭	器	澡
专	转	传
牢
军	库	裤	连
共	供	并	
兵	宾
迟	尺	尽	民	眠
底	纸	低	抵	
婚
官	馆	管	算
竹	行	
洗	选
笑	笔
论	轮
坐	座
猫	狗	
够
新
斤	近	听	诉	所	呢		
革	鞋
候	族 	
秩
楚	麻	
划
瓶
联
聊
印
谈
烧
假
刷
舞
鼻
警
嘴
蕉
